NO ./xpm/no.xpm
SO ./xpm/so.xpm
WE ./xpm/we.xpm
F 0,0,0
EA ./xpm/ea.xpm

C 100,100,255


11111111111111111111111111111
1000000000000000000000N1000001
10111111101111111011111 111101
101000001010000010100011110111
101011101010111010101111101101
101010001010101010100000101101
101011111010101011101110101101
101000000010100000001010001101
101111111110111101101011111101
10000000000000000000D000000001
111111111111011111111011111111
100000000000010000000010000001
101111101111110111110111110101
101000101000000100010001000101
101011101011111101110111101101
101010001010000001000100001101
101011111011111111101111101101
100000000000000000000000000001
1D11111111111111111111111111D1
111111111111111111111111111111
